15 15 3
###############
#S.........D..#
#.a.###......$#
#O..e.T.......#
#.....$...c...#
#..........T..#
#.....Y$....#A#
#$...........T#
#....##.....d.#
#...C#...#....#
#.y......T.####
#..#....#.T#.E#
#.....$...#...#
#Bb....#.#O...#
###############