8 16 3
################
#S..a..A.T..c..#
#Z...$.##....B.#
#..T...#.Y$....#
#...b.......X..#
#..x.y..$..C.zE#
################