16 7 3
################
#S.......T.....#
#....$.##......#
#..P...#..$.p..#
#..............#
#.......$......#
################